1111111111111
100100C000001
1000011110001
1P0011CE00001
1111111111111