1111111111111111111111111111111111111111111111111111111111
1E0000000000000C00000C000000000000000000000000000000000001
1010010100100000101001000000010100000000000000000000000001
1010010010101010001001000000010100000000000000000000000001
1010010010101010001001000000010100000000000000000000000001
1010010010101010001001000000010100000000000000000000000011
1010010010101010001001000000010100000000000000000000000011
1010010010101010001001000000010100000000000000000000000011
1010010010101010001001000000010100000000000000000000000011
1010010010101010001001000000010100000000000000000000000011
1010010010101010001001000000010100000000000000000000000011
1010010010101010001001000000010100000000000000000000000011
1010010010101010001001000000010100000000000000000000000011
1010010010101010001001000000010100000000000000000000000011
1010010010101010001001000000010100000000000000000000000011
1010010010101010001001000000010100000000000000000000000011
1010010010101010001001000000010100000000000000000000000011
1010010010101010001001000000010100000000000000000000000011
1010010010101010001001000000010100000000000000000000000011
1010010010101010001001000000010100000000000000000000000011
1010010010101010001001000000010100000000000000000000000011
1010010010101010001001000000010100000000000000000000000011
1010010010101010001001000000010100000000000000000000000011
1010010010101010001001000000010100000000000000000000000011
1010010010101010001001000000010100000000000000000000000011
1010010010101010001001000000010100000000000000000000000011
1010010010101010001001000000010100000000000000000000000011
1010010010101010001001000000010100000000000000000000000011
1010010010101010001001000000010100000000000000000000000011
1010010010101010001001000000011000000000000000000000000011
1P0000000C00C000000000000000000000000000000000000000000C11
1111111111111111111111111111111111111111111111111111111111